11111111111111111
10001000100010001
10101010101010101
10101010101010101
10101010101010101
10101010101010101
10101010101010101
10101010101010101
10101010101010101
1E101010101010101
1P1000100010001C1
11111111111111111