1111111111111111111111111111111111
1C1000000000000C00000C000000000001
101000C0C0C0000C00000C000000000001
1C0000000000000C00000C000000000001
1010010100100000101001000010010101
101000C0C0C0000C00000C000000000001
1C0000000000000C00000C000000000001
1010010100100000101001000010010101
1010010010101010001001000000010101
1P0000000C00C00000000E000000000EC1
1111111111111111111111111111111111