111111111
1CCCCCCC1
1CCCCCCC1
1CCCCCCC1
1CCCECCC1
1CCCCCCC1
1CCCCCCC1
1PCCCCCC1
111111111