11111111111
100C0110001
1C00P010001
10000000001
111C0001101
1C1000000E1
11111111111